############################################################\n############################################################\n###           ##############################################\n###           ##############################################
###                    #####################################
###                    #####################################
###                    #####################################
##################     #####################################
##################     #####################################
##################     #####################################
##################              ############################
##################              ############################
##################              ############################
##################              ############################
##################              ############################
############################################################
############################################################
############################################################
############################################################
############################################################
############################################################
############################################################
############################################################
############################################################
############################################################
############################################################
############################################################
############################################################
############################################################
############################################################